11111111111111111111111111
10000000000000000000000001
1P00CCCCCCCCCCCCCC000000E1
11111111111111111111111111
