1111111111111111111
1PCC1CCC1CCC1CCC1C1
11C1111C1C1111C11C1
10C0C0C0C0C0C0C0C01
1C11111C11111C111C1
101CCC1CCCCC1CCC0C1
1C1C11C1111111C1C11
101C1CCCCCCCC1C1C11
1C1C11111C1111C1C11
101CCCCCCCCCCCC1111
1C11111111111111CC1
10C0C0C0C0C0C0C0CE1
1111111111111111111
