1111111111111111111111111111
1P0000000000C001000010CCCE01
1001000CCCCCCCC1CCCCCCC00001
1000000000000000000000000001
100100010000C00000000G000001
100100010000CCCCCCC000100001
1000000000000000000000000001
100100010000C0000C0000100001
1000000000000000000000000001
10010CC10000CCCCCCC000100001
1000000000000000000000000001
10010CC10000CCCCCCC000100001
1111111111111111111111111111
