111111111111111111111111111111
1C0G000CCCCC000G000000G0G0G0C1
1C11110111110111111111111111C1
1C1CCCCCCCCCCCCC1CCCCCCCCCC1C1
1C1011111E1111101C1111111101C1
1C101000G0G000101C1000000101C1
1C101110111011101C1011110101C1
1CCCCCC0C0PCCCCCCC1CCCCCCCCC01
1C111101110111111C1011111101C1
1C100G0G000000000C1000000101C1
1C101101111111111C1011110101C1
1C1CCCCCCCCCCCCC1CCCCCCCCCC1C1
1C101101111111101C1111111101C1
1C10100000G000101C1000000101C1
1C101110111011101C1011110101C1
1C0G000CCCCC000G000000G0G0G0C1
111111111111111111111111111111
